Date,Description,Amount,Withdrawals,Deposits,Balance
3/31/2021,INTEREST PAYMENT ,0.75,,$0.75 ,"$31,170.09 "
3/26/2021,ONLINE TRANSFER FROM      XXXXX4446 ,1768.00,,"$1,768.00 ","$31,169.34 "
3/12/2021,ONLINE TRANSFER FROM      XXXXX4438 ,400.00,,$400.00 ,"$29,401.34 "
3/12/2021,ONLINE TRANSFER FROM      XXXXX4446 ,368.01,,$368.01 ,"$29,001.34 "
2/28/2021,INTEREST PAYMENT ,0.64,,$0.64 ,"$28,633.33 "
2/23/2021,ONLINE TRANSFER FROM      XXXXX4438 ,700.00,,$700.00 ,"$28,632.69 "
